mild_climate =
{
	farm_rgo_size = 0.0
	farm_rgo_eff = 0.0
	mine_rgo_size = 0.0
	mine_rgo_eff = 0.0
}

temperate_climate =
{
	farm_rgo_size = 0.0
	farm_rgo_eff = 0.0
	mine_rgo_size = 0.0
	mine_rgo_eff = 0.0
}

harsh_climate =
{
	farm_rgo_size = 0.0
	farm_rgo_eff = 0.0
	mine_rgo_size = 0.0
	mine_rgo_eff = 0.0
	max_attrition = 5
}

inhospitable_climate =
{
	farm_rgo_size = 0.0
	farm_rgo_eff = 0.0
	mine_rgo_size = 0.0
	mine_rgo_eff = 0.0
	max_attrition = 10
}

 
mild_climate = { 

654 696 573 626 588 422 442 450 279 310 307 333 340 320 339 414 405 434 322 282 290 379 357 360 410 396 449 443 469 
483 542 196 344 319 342 281 303 289 265 260 245 170 184 147 172 217 186 241 219 181 607 541 568 614 677 720 680 647 
621 636 524 480 486 753 794 797 817 821 849 780 816 842 801 804 799 846 918 903 873 885 944 891 922 958 960 952 552 
500 646 671 697 693 563 604 584 649 635 712 728 775 793 764 770 745 791 856 1082 1062 1058 900 929 967 973 888 901 
870 893 1035 1012 1033 949 975 939 916 899 966 932 947 920 907 1040 1025 1003 1055 863 866 717 1204 1071 1053 1100 1126 1056 1081 
1131 1261 1210 1291 1289 1430 1383 1439 1481 1155 1130 1157 1163 1186 1211 1185 1275 1141 1121 1177 1236 1273 1301 1320 1229 1294 1344 1341 1468 
1347 1337 1313 1515 1522 1532 1551 1780 1774 1763 1637 1653 1683 1660 1691 1714 1692 1704 1690 1612 1647 1629 
1623 1655 1658 1663 1680 1661 1670 1743 1731 1730 1716 1707 1732 1746 1812 
1424 


574 522 583 570 634 711 759 869 892 969 
1175 1156 1143 1176 1183 1146 1124 1070 1027 1168 1167 90 105 193 145 227 278 247 240 248 331 352 377 
416 497 489 530 659 792 683 645 1019 1160 1137 1166 1203 1217 1359 1367 1334 1348 1331 1352 1363 1360 881 
978 1048 1092 1115 1151 1470 1490 1494 1441 1418 1417 1443 1569 1547 1535 1648 178 69 20 42 39 







519 46 833 692 
	 
	 
	122
	519 
} 
 
temperate_climate = { 




166 140 156 126 102 116 103 100 134 155 141 146 212 220 194 226 205 238 250 232 254 273 259 269 257 244 243 
253 270 280 300 301 321 312 277 294 252 246 225 179 304 316 296 272 206 440 426 437 482 499 608 620 740 813 668 
796 729 760 722 643 629 655 827 757 689 1061 1039 963 985 919 911 971 868 981 1041 989 1047 935 988 1004 1038 962 923 
905 992 993 959 980 927 910 521 520 547 526 538 737 415 403 387 435 413 446 462 436 460 401 371 389 407 432 412 
386 397 431 445 448 430 363 346 358 341 374 383 400 382 411 385 484 487 420 452 421 454 315 323 293 271 251 204 
235 229 256 261 354 334 367 392 380 370 399 441 425 286 291 308 268 345 362 337 311 369 361 394 325 111 159 121 
158 203 221 191 222 160 188 154 164 150 211 234 190 255 236 242 267 266 518	519 135 106 109 120 115 129 124 119 
572 593 556 529 564 575 505 537 511 506 475 488 675 670 695 633 699 618 589 637 642 619 694 666 653 625 592 606 
525 503 561 544 560 535 510 495 459 467 481 466 455 456 474 494 490 465 517 504 516 545 509 501 532 557 553 528 
571 546 598 559 581 612 555 743 706 679 766 734 739 681 781 776 700 748 664 704 674 703 848 983 1007 1028 977 
1021 1020 1006 951 956 1001 1044 1059 1072 1045 1036 1080 1083 1097 1094 1063 1101 751 772 735 750 742 802 829 708 798 826 
831 812 777 847 830 880 875 926 906 767 795 805 970 858 867 913 879 954 843 909 822 473 477 507 515 543 558 577 
658 616 631 623 630 641 617 597 601 622 615 652 660 686 719 761 755 673 721 714 531 518 738 710 698 702 756 763 
733 732 771 790 803 715 824 857 887 838 860 908 889 864 898 921 894 886 862 946 917 896 968 950 948 1026 996 1034 
934 871 861 1224 1112 1148 1079 1110 1246 1202 1362 1389 1361 1338 1271 1264 1409 1463 984 976 1089 1050 1029 987 1099 1232 1184 1233 
1125 1200 1330 1398 1449 1495 1410 1453 1392 1437 1414 1479 1528 1368 1381 1356 1452 1391 1390 1436 1454 1457 1460 
1464 1476 1511 1484 1480 1527 1483 1492 1487 1508 1519 1563 1578 1557 1590 1650 1672 1696 1676 1706 1710 1717 1735 1738 
1748 1751 1752 1764 1760 1767 1776 1781 1797 1788 1790 1747 1750 1709 1643 1656 1675 1687 1702 1701 1734 1736 


1810 



366 402 288 264 314 478 40 52 49 1340 1374 1315 1328 1266 1272 1335 1349 1377 1406 1399 1382 26 50 64 
79 93 99 112 174 132 201 162 218 348 365 336 375 373 416 433 453 471 502 393 476 404 551 
591 678 468 533 565 539 585 727 964 548 566 554 669 687 1105 1122 1350 1332 1118 1182 1223 1280 1366 
1321 1326 1302 1270 1250 1214 819 914 850 941 1005 1077 1088 1073 1018 1057 1102 1144 1427 


852 924 485 837 839 350 
} 
 
harsh_climate = { 


29 151 223 148 209 230 171 192 527 650 582 496 741 656 990 1076 1095 1051 328 275 356 447 444 258 
285 353 324 513 587 624 508 451 470 479 602 661 578 663 895 874 925 840 884 865 930 853 818 1074 953 610 611 755 808 
765 784 825 832 810 783 991 999 902 915 982 1016 878 1221 1134 1098 1064 1046 1140 1180 1133 1170 1245 1283 1162 1254 1314 1397 1384 
1369 1346 1325 1401 1372 1292 1306 1308 1329 1285 1304 1311 1300 1324 1277 1284 1303 1278 1288 1263 1268 1256 1249 1385 1412 1420 1434 1017 1009 
1008 1068 1090 1171 1116 1091 1037 1107 1149 961 1011 986 1084 1370 1262 1104 1087 1255 1228 1336 1147 1198 1189 1085 1132 1305 
1274 1269 1298 1339 1318 1230 1227 1181 1251 1279 1395 1375 1380 1405 1364 1538 1416 1465 1516 1466 1505 1502 1459 
1524 1378 1472 1462 1425 1435 1404 1408 1373 1489 1431 1497 1514 1531 1500 1507 1510 1501 1520 
1534 1523 1543 1513 1518 1564 1526 1549 1550 1552 1566 1530 1415 1407 1537 1517 1622 1561 1640 1581 1618 1594 1584 
1596 1635 1592 1677 1662 1636 1688 1805 1798 1756 1671 1633 1697 1699 1744 1713 1742 1745 1681 1725 1718 1698 1686 1679 
1678 1685 1693 1813 1652 

1803 
149 173 183 200 237 113 127 104 96 101 81 391 
330 284 464 514 498 639 890 723 632 1015 1199 1145 1193 1201 1212 1238 1191 43 53 61 78 67 54 
51 47 57 48 731 713 746 1307 1322 1327 1351 1444 1486 1423 1411 1393 59 76 92 91 83 88 137 
249 239 283 317 306 327 309 395 390 424 463 492 562 376 457 417 472 530 600 876 851 605 594 726 
638 788 945 928 1013 955 685 657 718 754 1154 1123 1296 1159 1242 1196 1248 1128 1113 1165 1065 1030 
1129 786 854 844 912 994 1049 1010 1054 1117 1169 1451 1445 41 19 



995 
997 855 1178 1257 1499 1580 1593 
1111 108 1807 534 834 
	 
	 
} 
 
inhospitable_climate = { 
762 724 758 897 1066 1281 1286 1253 1267 1355 1413 1471 
943 1358 1108 1109 1127 1433 1496 1429 1207 1342 1402 1295 1192 1573 1571 1565 1588 1583 1757 1667 1657 1628 1749 1755 1794 
1802 1432 1421 1394 1428 1426 1450 1442 1488 
1467 1448 1461 1491 1458 1469 1540 1554 1558 1576 1575 1570 1553 1544 1556 1365 1345 1317 1258 1387 1310 1438 1379 
1396 1357 1440 1475 1482 1546 1478 1529 1503 1446 1419 1605 1473 1597 1607 1665 1703 1695 1638 1649 1586 1600 1604 
1598 1615 1632 1560 1533 1619 1639 1626 1582 1595 1609 1631 1608 1585 1589 1646 1673 1654 1689 1634 1645 1641 1711 
1783 1811 1674 1724 1613 1620 1664 1740 1765 1739 1787 1791 
1792 1801 1795 1806 1766 1804 1733 1722 1809 1669 
1737 1772 1700 1727 1793 1754 189 176 169 210 233 143 216 161 114 439 378 438 332 224 274 
128 153 298 406 287 381 295 384 769 651 569 567 1213 1220 1024 1052 1096 1139 1161 1172 1215 71 45 89 
110 80 65 72 63 117 86 95 97 130 167 152 123 180 182 199 263 168 313 338 318 372 419 458 
398 540 523 613 595 773 823 815 701 744 828 1188 1209 1235 1219 1187 1174 1297 1247 1135 1226 1197 1069 1078 
1114 965 931 979 1106 1060 1142 1218 1343 1225 1240 1290 1376 1354 1388 98 213 292 302 202 187 305 550 590 
603 579 549 672 648 684 787 736 707 691 705 665 872 1032 1014 1067 942 778 800 820 957 1042 836 690 
752 814 841 1043 937 938 1309 1299 1244 1265 1243 1252 1194 1158 1136 1260 1195 1205 1173 1153 1234 1216 972 998 
883 882 749 644 682 904 809 725 730 782 807 


1179 536 1023 768 
1504 1164 1276 1422 1624 1758 1796 175 1651 1611 1729 

628 
1728 1778 1777 1659 
1784 1753 1726 1603 1682 1610 1579 1627 1525 1541 1545 
1614 1762 1773 1705 1521 1512 1559 118 
} 
