europe = { 
	provinces = { 
29 151 166 140 156 126 102 116 103 100 134 155 141 146 223 148 209 230 171 192 212 220 194 226 205 238 250 
232 254 273 259 269 257 244 243 253 270 280 300 301 321 312 277 294 252 246 225 179 304 316 296 272 206 527 650 
762 440 426 437 482 499 608 582 496 620 740 741 656 724 758 813 668 796 729 760 722 643 629 655 827 757 689 654 
696 990 1076 897 1095 1061 1039 1051 963 985 919 911 971 868 981 1041 989 1047 935 988 1004 1038 962 923 905 992 993 959 
980 927 910 573 521 520 547 526 538 626 588 737 415 403 422 387 435 413 446 442 462 450 436 460 401 371 389 407 
432 412 386 397 431 445 448 430 363 346 358 341 374 383 400 382 411 385 484 487 420 452 421 454 315 323 293 271 
251 204 235 229 256 261 354 334 367 392 380 370 399 441 425 286 291 308 268 345 362 337 311 279 310 307 333 340 
320 369 361 339 414 394 405 434 325 322 328 282 290 275 379 357 360 356 447 444 410 396 449 443 469 483 542 111 
159 121 158 203 221 191 222 160 188 154 164 150 211 234 190 255 196 236 258 242 267 285 266 344 353 324 319 342 
281 303 289 265 260 245 170 184 147 172 217 186 241 219 181 122 142 135 106 109 120 115 129 124 119 572 593 607 
541 568 513 556 529 564 575 505 537 511 506 475 488 614 677 720 680 675 670 695 633 699 618 589 637 642 619 694 
666 653 625 592 606 525 503 561 544 560 535 510 495 459 467 481 466 455 456 474 494 490 465 517 504 516 545 509 
501 532 557 553 528 587 571 546 598 559 581 612 624 647 621 636 524 480 486 508 451 470 479 555 602 661 578 663 
743 706 679 766 734 739 681 781 776 700 748 664 704 674 703 753 794 797 817 821 849 895 874 780 816 842 801 804 
799 848 846 918 903 873 885 944 891 922 958 960 952 983 1007 1028 977 1021 1020 1006 951 956 1001 1044 1059 1072 1045 1036 
1080 1094 1063 1101 751 772 735 750 742 802 829 708 798 826 831 812 777 847 830 880 875 926 906 767 795 805 970 858 
867 913 879 954 843 909 822 925 840 884 865 930 853 818 1074 953 473 477 507 515 552 500 543 558 577 658 616 646 
631 671 610 611 697 693 563 604 584 623 630 641 617 597 601 622 615 649 635 652 660 686 712 728 775 719 793 761 
764 755 673 721 714 531 518 738 710 698 702 756 763 733 732 771 790 803 715 824 770 745 791 808 765 784 825 832 
810 783 857 887 838 860 908 889 864 856 870 893 975 939 916 899 966 932 947 920 907 871 863 866 861 878 717 984 
976 1017 1009 1008 1068 1090 1171 1155 1116 1091 1037 1107 1149 943 961 1011 986 1089 1050 1029 987 1130 1084 1099 1157 1163 1186 1211 
1185 1275 1232 1141 1121 1177 1184 1233 1236 1273 1301 1320 1229 1294 1344 1341 1108 1109 1127 1207 1342 1262 1295 1125 1192 1104 1087 1255 
1200 1228 1336 1147 1198 1189 1085 1132 1305 1274 1269 1298 1339 1318 1230 1227 1181 1251 1279 1330 995 852 519 
536 485 692 534 834 350 855 1178 833 837 839 1164 1276 118 
		 
1391 1373 1394 1408 1421 1432 1390 1426 1428 1442 1450 1461 1448 1467 1489 1488 1491 1097 1083 1058 1082 1034 1026 996 948 
1062 999 950 968 991 1100 1071 1053 1035 1033 1012 973 967 946 898 921 862 886 894 917 896 900 902 929 888 901 934 949 915 
982 1016 1055 1003 1025 1040 1358 1429 1370 1402 1380 1405 1375 1433 1496 1541 1545 1525 1538 1505 1516 1521 1512 1395 1416 1465 
1466 1502 1449 1495 1524 1459 1479 1528 1499 1473 1410 1364 1398 1453 1414 1468 1437 1392 1378 1347 1368 1337 1313 
1381 1356 1404 1472 1462 1425 1435 1452 
	} 
	#assimilation_rate = -0.25
} 
 
asia = { 
	provinces = { 
1221 1204 1224 1126 1134 1098 1064 1046 1140 1112 1148 1056 1079 1110 1081 1180 1133 1131 1170 1245 1246 1283 1202 1162 1362 1254 1314 1397 1384 
1369 1346 1325 1401 1372 1389 1361 1261 1210 1292 1308 1329 1385 1412 1420 1430 1383 1434 1409 1439 1355 1481 1463 1413 1471 1573 1571 1565 
1588 1583 1757 1667 1657 1628 1749 1755 1794 1802 
1458 1431 1436 1454 1469 1497 1514 1531 1540 1457 1460 1464 1476 1511 1484 1480 1500 
1507 1527 1510 1501 1520 1534 1483 1492 1487 1508 1519 1515 1523 1522 1543 1554 1532 1551 1558 1576 1563 1575 1570 
1553 1544 1556 1365 1345 1317 1258 1387 1310 1438 1379 1396 1357 1440 1513 1475 1482 1518 1564 1526 1549 1550 1552 
1566 1546 1478 1529 1503 1446 1530 1415 1407 1419 1605 1537 1597 1607 1665 1703 1695 1638 1649 1578 1557 1586 
1517 1622 1561 1600 1590 1604 1598 1615 1640 1632 1560 1533 1581 1619 1639 1618 1626 1594 1582 1595 1584 1596 1635 
1609 1631 1608 1585 1592 1589 1646 1673 1654 1689 1650 1634 1662 1645 1636 1641 1677 1672 1688 1696 1676 1711 1706 
1710 1717 1735 1738 1748 1751 1752 1764 1760 1767 1776 1780 1783 1781 1797 1788 1790 1805 1798 1811 1774 1763 
1756 1671 1633 1637 1653 1683 1660 1697 1674 1699 1724 1744 1713 1691 1714 1692 1742 1745 1747 1750 1709 1681 1704 
1690 1725 1612 1613 1620 1647 1629 1623 1643 1656 1655 1658 1664 1663 1680 1661 1675 1670 1718 1743 1731 1730 1687 
1716 1707 1702 1732 1698 1686 1679 1678 1685 1693 1701 1813 1734 1736 1740 1746 1652 1765 1739 1787 1791 
1812 


1424 

1792 
1810 


1801 1795 

1803 1806 1766 1804 1733 1722 1809 1669 1737 1772 1700 1727 1793 1754 



1648 1807  1504 1422 1624 1758 1796 1580 1593 
1651 1611 1729 1728 
1778 1777 1659 
1784 1753 1726 1603 1682 1610 1579 1627 1614 1762 1773 
1705 1559 

1253
1249
1263
1256
1268
1264
1267
1281
1277
1303
1284
1271
1278
1288
1286
1285
1300
1324
1304
1289
1291
1306
1311
1338
	} 
	#assimilation_rate = -0.25
 
} 
 
africa = { 
	provinces = { 
1066 
189 176 169 210 233 149 173 183 200 237 113 127 143 104 96 101 81 216 161 
114 366 402 391 330 288 264 314 284 464 478 439 378 438 332 224 274 128 153 298 406 287 381 
295 384 574 522 514 583 498 570 634 639 711 759 869 892 969 890 769 723 632 651 569 567 1175 
1156 1143 1176 1183 1146 1124 1070 1027 1015 1213 1220 1024 1052 1096 1139 1161 1168 1167 1145 1172 1193 1215 1201 
1212 1238 1191 71 45 43 53 61 78 67 89 110 80 40 52 49 54 51 47 57 65 72 48 
63 117 86 95 97 130 167 152 123 180 182 199 263 168 313 338 318 372 419 458 398 540 523 
613 595 731 713 746 773 823 815 701 744 828 1188 1209 1235 1219 1187 1174 1297 1247 1135 1226 1197 1069 
1078 1114 965 931 979 1106 1060 1142 1218 1343 1340 1307 1374 1315 1328 1266 1272 1335 1349 1377 1322 1327 1351 
1225 1240 1290 1376 1354 1388 1406 1399 1382 1444 1486 1423 1411 1393 26 50 59 64 76 92 91 98 79 
83 88 90 105 93 99 112 193 145 227 174 132 201 162 218 137 249 213 292 302 202 187 305 
278 247 239 240 248 283 331 317 306 327 309 352 348 365 336 377 375 373 395 390 416 424 463 
433 453 471 497 489 492 562 376 457 417 472 550 530 590 502 393 476 404 551 603 659 591 678 
468 533 565 539 585 600 579 549 672 648 684 787 727 736 792 964 876 851 548 566 554 605 594 
726 638 707 691 705 665 872 788 945 1032 928 1013 1014 1067 942 778 800 820 957 1042 955 685 657 
669 718 683 645 687 754 836 690 752 814 841 1043 937 938 1019 1105 1122 1154 1160 1137 1166 1203 1217 
1309 1299 1244 1265 1243 1359 1367 1350 1332 1334 1118 1123 1348 1331 1352 1363 1252 1296 1194 1158 1159 1242 1136 
1260 1360 1195 1182 1223 1196 1248 1205 1173 1153 1234 1216 1280 1366 1321 1326 1302 1270 1250 1214 1128 1113 1165 
1065 1030 1129 972 998 883 882 749 644 682 904 809 725 730 782 807 819 786 854 844 914 912 850 
941 881 978 994 1048 1049 1092 1010 1054 1005 1077 1088 1073 1018 1057 1102 1144 1115 1117 1151 1169 1451 1445 
1427 1470 1490 1494 1441 1418 1417 1443 1569 1547 1535 178 69 41 20 42 39 924 1179 108 1023 46 997 
1257 768 175 628 1111 
1199 
	} 
	#assimilation_rate = -0.25
 
} 
 
north_america = { 
	provinces = { 














	} 
	assimilation_rate = 0.5
	farm_rgo_size = 10
	mine_rgo_size = 10
} 
 
south_america = { 
	provinces = { 
19 










	} 
	assimilation_rate = 0.5
	farm_rgo_size = 10.0
	mine_rgo_size = 10.0
 
} 
 
oceania = { 
	provinces = { 





	} 
	assimilation_rate = 0.5
	farm_rgo_size = 10.0
	mine_rgo_size = 10.0
} 
