max_provinces = 1817 
 
sea_starts = { 
667 716 859 806 936 785 835 676 576 493 1075 1150 1239 1022 609 388 359 409 408 364 326 276 195 138 144 185 214 125 131 
262 231 335 197 107 157 136 68 58 73 82 85 84 77 133 228 299 349 429 512 343 428 329 427 580 586 596 640 747 
662 709 779 789 845 774 877 1002 1120 1152 974 933 1031 1086 1138 1237 1222 811 1477 1572 1206 1316 1403 1498 1536 1567 1542 1485 1587 
1602 1601 1644 1668 1715 1741 1779 1800 1799 


1493 1386 1353 1371 1506 1539 
1574 1509 1474 1555 1312 1208 1093 940 599 418 368 355 347 351 208 75 34 23 25 30 44 198 94 33 56 16 32 31 17 
14 

22 13 37 12 
9 27 10 11 8 177 139 5 3 2 7 
6 28 21 36 74 163 297 60 24 18 1 38 87 491 1770 1759 1761 1721 1616 1591 1562 1577 1617 1625 1712 1771 1775 1808 1000 
1287 1333 1455 1456 1548 1568 1642 1768 1606 1621 1719 1723 1789 1782 1708 1599 688 1190 1119 1241 1769 1666 

1816 1814 
1815 
4 70 35 1720 1786 1785 1684 
1319 1630 1400 1447 1694 1293 1103 15 

62
66
165
207
215
423
461
627
1231
1259
1282
1323
55

} 

definitions = "../mod/CCK/map/definition.csv"
provinces = "provinces.bmp" 
positions = "positions.txt" 
terrain = "terrain.bmp" 
rivers = "rivers.bmp" 
terrain_definition = "terrain.txt" 
tree_definition = "trees.txt" 
continent = "continent.txt" 
adjacencies = "adjacencies.csv" 
region = "region.txt" 
region_sea = "region_sea.txt" 
province_flag_sprite = "province_flag_sprites" 
 
 
border_heights = {
	500
	800
	1100
}

terrain_sheet_heights = {
	500 #150
}

tree = 350

border_cutoff = 1100.0

